; Default CSSE2002 Pacman Map
; board Keys
; getWidth, getHeight
;   - X Wall
;   - 0 No Item, 1 dots
;   - B Big dots spawn ( occupied ), b big dot spawn ( not occupied )
;   - $ Ghost spawn zone
;   - P pacman spawn zone
[Board]
23,24
XXXXXXXXXXXXXXXXXXXXXXX
XB1111111111111111111BX
X1XX1XXXXX1X1XXXXX1XX1X
X1XX1XXXXX1X1XXXXX1XX1X
X1111111111X1111111111X
X1XXXXXXXX1X1XXXXXXXX1X
X1XXXXXXXX1X1XXXXXXXX1X
X1111111111P1111111111X
X1XXX1XXXXXXXXXX1XXXX1X
X111111111111111111111X
XXXXXX1XXXX$XXXX1XXXXXX
XXXXXX1XXXXXXXXX1XXXXXX
XXXXXX1XXXXXXXXX1XXXXXX
X111111XXXXXXXXX111111X
X1XXXX11111111111XXXX1X
X1XXXXXXXX1X1XXXXXXXX1X
X111X111111X111111X111X
X1X1X1XXXXXXXXXXX1X1X1X
X1X1X1XXXXXXXXXXX1X1X1X
X1X11111111X11111111X1X
X1XX1XXXXX1X1XXXXX1XX1X
X1XX1XXXXX1X1XXXXX1XX1X
XB1111111111111111111BX
XXXXXXXXXXXXXXXXXXXXXXX

[Game]
title = CSC-301 PacMan Final
author = Sean and Rodrigo
lives = 3
level = 0
score = 123
hunter = 1,1,LEFT,0,PHIL
blinky = 3,6,UP,FRIGHTENED:15
inky = 1,6,UP,SCATTER:7
pinky = 8,6,UP,FRIGHTENED:15
clyde = 6,4,UP,CHASE:4

; Must have one blank line between each block.
; Comments do not count as a line
[Scores]